?#####?###########?#####?###?###########?
#.....#...........#.....#...#...........#
?##.#.#######.###.#.###.#.#.###########.#
#...#.#.....#.#...#.#...#.#.........#...#
#.###.#.###.#.###.#.#.###.#########.#.#.#
#.#.#.#.#...#...#...#.#.....#.......#.#.#
#.#.#.#.#.#####.#####.#.#####.?######.#.#
#.#.....#.#.....#.....#.#.....#.......#.#
#.#######.#.#####.#####.#.##?##.#######.#
?.......#...#...#...#...#...#...#.......#
?.#####.?####.#.###.#.#####.?##.#.######?
?..D???.#.#...#...#.#.#.....#...#.#.....#
?###?##.#.#.#.#####.#.#.#####.###.#.###.#
?...#...#.#.#.......#.#.....#.#.#.#.#...#
?.?.#.?##.#.########?.#####.#.#.#.#.#.##?
?.?...#...#.#...#...#...#...#.#...#.#...#
?.##?####.#.#.#.#.#####.#.?##.#.#######.#
?...#...#...#.#...#.....#.#...#.#.....#.#
??#.#.#.#.###.#.###.####?.?##.#.#.###.#.#
???...#.#.#...#.#.......#.#...#...#.#.#.#
?######.#.#.###.#.#####.#.#.#######.#.#.#
?.......#.#...#.#...#X#.#.#.#...#...#.#.#
?.##?####.###.#####.#.###.#.###.#.#.#.#.#
?...#...#...#.#.....#.#...#...#...#.#.#.#
??#.?##.###.#.#.####?.#.?####.#.###.#.#.#
???.#.....#...#.....#.#.#.....#.#.#...#.#
???.#.#.#####.#####.#.#.?##.###.#.#####.#
???.#.#.#.....#.....#...#...#.#...#...#.#
???.#.###.#####.######?##.###.###.#.#.#.#
???.#...#...#...#.....#.....#.....#.#.#.#
?##.?##.#.###.#####.#.###.#.#.#####.#.#.#
?...#...#.#...#.....#...#.#.#.#.....#.#.#
?.??#.###.#.#####.#####.###.#.#.###.#.#.#
?.?O......#.....#.#...#.....#.#...#.#...#
?.?#######?###?.#.#.#.#######.###.#.###.#
?.?.......#...#.#...#.#.#...#.#...#...#.#
?.?.#####.?.#.?.#.###.#.#.#.#.#####.#.#.#
?.?.#...#.?.#.?.#.#...#...#...#...#.#.#.#
?.#.###.#.#.#.#.###.###.#######.#.###.#.#
?.......#...#.......#...........#.....#.#
??######??##??######?###########?#####?#?